1111111111111
100C0000000E1
1P00000C00001
100000000C001
1111111111111
