1111111111111
10000000000E1
100P000000001
10000000C0001
1111111111111