1111111111
1P000000E1
1000C00001
1000000C01
1111111111
