111111111111111
1P00000E0000C01
100C00000000001
100000000000001
10000C000000001
100000C00000001
111111111111111
