11111111111111111111111111111
1P000000000000000000000000001
10000C00001111000000000000001
10000000010000000000000000C01
100000C0001000C00000111000001
100000000100000C0000000000C01
10000000001000000000000100001
10000000000000000000110000001
100000000000CC000000000000001
1000C000000000C000000000000E1
11111111111111111111111111111